
NO ./assets/WALL.xpm
SO ./assets/WALL.xpm
WE ./assets/WALL.xpm
EA ./assets/WALL.xpm

F 75,186,0
C 77,159,240

1111111111111111111111111111111111111111111111111111111111
1000000000000000100000000000000000000000000000000000000001
1111111111111100100000000000000000000000000000000000000001
1000000000000000000000000000000000000000000000000000000001
1000000000000011111111110000000000000000000000000000000001
1000000000000011100000000000000000000000000000000000000001
1110000000000011100000000000000000000000000000000000000001
1000000000000000000000000000000000000000000000000000000001
1000000000000000000000000000000000000000000000000000000001
1000000000000000000000000S00000000000000000000000000000001
1000000000000000000000000000000000000000000000000000000001
1000000000000000000000000000000000000000000000000000000001
1000000000000000000000000000000000000000000000000000000001
1000111111111111111111111100000000000000000000000000000001
1000000000000000000000000000000000000000000000000000000001
1000000000000000000000000000000000000000000000000000000001
1111111111111111111111111111111111111111111111111111111111





